999000666001000
999100666000010
999000005555550
000bbbb05cc5cd0
100bbbb0dc55c50
000000015cccc51
aaa100005c5cc50
aaa000775c5cc50
aaa000775555550
000000770000000
001002200888000
000002200888010
001010000888100
330044000888100
330044000888000